389,443,248,370,166,370,111,311,47,224,328
361,362,173,319,97,347,78,304,82,258,346
289,279,75,342,129,404,163,377,183,355,329
314,471,263,467,248,477,211,419,155,322,221
270,339,131,386,162,432,169,393,162,345,275
295,452,244,462,240,478,210,423,160,333,215
